%%%%%%%
%     %
% P   %
%     %
%%%%%%%
