%%%%%%%
%.   .%
%   P %
%%%%%%%
